2
e 1 6 1
p 1 3 0
[0]
[0]
[0]
[0]
[0]

2
e 1 7 1
p 1 3 1
[1]
[1]
[1]
[1]
[0]
[0]

2
e 0 5 2
p 4 5 2
[1, 1, 1, 0, 1]
[0, 1, 0, 1, 1]
[1, 0, 1, 0, 1]
[1, 1, 1, 1, 1]
[1, 1, 0, 0, 1]

1
e 0 5 3
p 3 2 3
[2, 1, 1, 2, 2, 0]
[2, 2, 0, 0, 1, 1]
[1, 2, 0, 2, 2, 2]
[1, 1, 0, 1, 0, 1]
[1, 1, 0, 2, 0, 1]
[2, 2, 2, 0, 0, 2]

1
e 0 3 4
p 5 5 4
[2, 2, 0, 0, 2, 2, 2, 2]
[1, 2, 1, 2, 0, 2, 0, 1]
[1, 2, 0, 2, 0, 1, 0, 1]
[0, 0, 0, 0, 1, 1, 0, 0]
[0, 0, 2, 0, 1, 2, 0, 0]
[0, 0, 1, 1, 1, 2, 2, 0]

3
e 3 0 5
p 5 8 5
[2, 2, 0, 2, 2, 2, 2, 2]
[1, 2, 1, 2, 0, 2, 0, 1]
[1, 2, 0, 2, 0, 1, 0, 1]
[0, 0, 0, 0, 1, 2, 0, 0]
[0, 2, 0, 0, 1, 2, 0, 0]
[0, 0, 1, 1, 1, 2, 1, 0]
[2, 2, 1, 1, 1, 2, 0, 0]
[2, 2, 2, 2, 2, 2, 2, 1]

0
e 9 2 5
p 4 4 6
[1, 2, 1, 1, 1, 2, 1, 1]
[1, 2, 0, 0, 1, 2, 2, 1]
[0, 2, 1, 2, 0, 2, 0, 1]
[1, 2, 0, 2, 2, 2, 0, 2]
[1, 1, 1, 3, 1, 0, 0, 2]
[0, 0, 1, 0, 1, 1, 0, 2]
[0, 1, 1, 1, 1, 2, 1, 0]
[1, 2, 2, 2, 0, 0, 1, 1]

3
e 3 0 5
p 5 8 7
[3, 1, 1, 3, 0, 0, 0, 2]
[3, 0, 3, 0, 0, 1, 3, 2]
[3, 0, 2, 2, 0, 3, 3, 2]
[3, 0, 0, 0, 2, 2, 0, 3]
[3, 0, 1, 1, 1, 3, 0, 3]
[3, 0, 3, 3, 3, 3, 3, 3]
[0, 0, 2, 3, 3, 3, 0, 3]
[1, 0, 2, 1, 1, 2, 0, 3]

0
e 0 2 5
p 8 4 8
[2, 3, 3, 3, 2, 1, 3, 0]
[2, 1, 0, 3, 2, 1, 3, 1]
[2, 3, 3, 2, 2, 1, 3, 1]
[3, 2, 2, 3, 3, 1, 1, 3]
[3, 2, 0, 0, 0, 1, 0, 3]
[3, 0, 2, 0, 0, 1, 0, 2]
[3, 0, 1, 1, 1, 1, 2, 2]
[2, 1, 1, 1, 1, 3, 3, 2]

1
e 7 0 5
p 7 8 9
[1, 0, 0, 3, 3, 3, 1, 1]
[1, 1, 0, 2, 3, 1, 2, 3]
[3, 3, 3, 2, 1, 1, 0, 2]
[2, 3, 3, 2, 0, 0, 2, 3]
[2, 0, 1, 2, 0, 0, 3, 3]
[2, 3, 3, 1, 1, 0, 1, 3]
[2, 3, 3, 1, 0, 0, 3, 3]
[1, 2, 2, 1, 0, 0, 0, 2]

0
e 9 8 5
p 2 2 10
[0, 0, 3, 1, 2, 2, 1, 3]
[1, 1, 1, 0, 2, 3, 3, 2]
[3, 2, 2, 2, 1, 3, 0, 0]
[2, 0, 3, 3, 3, 2, 0, 1]
[2, 3, 1, 0, 0, 0, 3, 1]
[3, 3, 0, 2, 1, 1, 1, 0]
[1, 4, 0, 1, 3, 2, 2, 2]
[0, 2, 1, 1, 2, 0, 3, 3]
