2
e 3 7 1
e 7 3 2
p 1 4
p 4 3
[1, 0, 0, 0, 0, 1]
[1, 0, 2, 2, 1, 1]
[2, 0, 2, 2, 2, 1]
[1, 0, 0, 1, 2, 1]
[1, 1, 2, 1, 1, 1]
[1, 1, 2, 0, 0, 0]

2
e 0 4 3
p 6 5
[0, 2, 1, 0, 2, 2]
[1, 1, 1, 1, 0, 1]
[0, 1, 1, 0, 2, 1]
[0, 2, 1, 2, 1, 1]
[1, 2, 1, 2, 1, 2]
[2, 2, 1, 2, 0, 2]

3
e 7 5 4
p 6 1
[2, 1, 1, 2, 2, 0]
[0, 0, 0, 0, 1, 1]
[1, 2, 0, 2, 2, 2]
[1, 1, 0, 1, 1, 1]
[1, 1, 1, 2, 0, 0]
[2, 1, 1, 0, 0, 2]

1
e 7 5
s 4 1 3
[2, 2, 0, 3, 3, 3, 2, 2]
[1, 2, 1, 2, 0, 2, 0, 1]
[1, 2, 0, 2, 0, 1, 0, 1]
[0, 0, 0, 0, 1, 2, 0, 0]
[0, 2, 0, 0, 1, 2, 0, 0]
[0, 0, 1, 1, 1, 2, 1, 0]
[2, 2, 1, 1, 1, 2, 0, 0]
[2, 2, 2, 2, 2, 2, 2, 1]

3
e 7 5
s 4 1 3
[2, 2, 0, 3, 3, 3, 2, 2]
[1, 2, 1, 2, 0, 2, 0, 1]
[1, 2, 0, 2, 0, 1, 0, 1]
[0, 0, 0, 0, 1, 2, 0, 0]
[0, 2, 0, 0, 1, 2, 0, 0]
[0, 0, 1, 1, 1, 2, 1, 0]
[2, 2, 1, 1, 1, 2, 0, 0]
[2, 2, 2, 2, 2, 2, 2, 1]

2
e 5 7 0
p 1 5
p 6 6
[1, 3, 3, 1, 1, 1, 2, 3]
[0, 1, 1, 1, 2, 2, 0, 0]
[2, 3, 3, 3, 2, 2, 2, 0]
[3, 3, 3, 2, 2, 2, 1, 0]
[0, 3, 0, 0, 0, 0, 0, 2]
[3, 3, 2, 0, 2, 1, 1, 2]
[1, 2, 2, 1, 0, 0, 1, 2]
[3, 3, 3, 2, 3, 3, 1, 1]